1 Section 01-17 se
constitution -(005 Equality is guaranteed by the Constitution.)	憲法

subtle -(007 A woman passed by me giving off a subtle scent of perfume. It reminded me of my ex-girlfriend.)	かすかな

be beside oneself (with ...) -(010 Bob was so beside himself that he could scarcely tell fact from fiction.)	(...で)ひどく興奮する、取り乱す

combine A with[and] B -(011 His new nobel, which combines prose with his gift for poetry, is going to be published.)	AとBを組み合わせる

poetry -(011 His new nobel, which combines prose with his gift for poetry, is going to be published.)	詩

up-to-date ... -(012 An up-to-date edition of the encyclopedia will come out next month.)	(形)(情報などが)最新の...

fable -(014 The following passage is quoted from a well-known fable.)	寓話

be eager to do -(018 This article contains tips for those who are eager to increase their vocabulary.)	しきりにdoしたがっている

be apt to do -(023 "I'm apt to buy things on impulse whenever something is on sale." "So am I.")	doしがちである

competent -(028 Competent mechanics are in great demand, so they earn decent wages.)	(形)能力[技能]を持つ

dismal -(030 His policy will no doubt lead to dismal consequences. It needs a thorough review.)	(形)(結果・状況などが)気分を暗くさせる

thorough -(030 His policy will no doubt lead to dismal consequences. It needs a thorough review.)	徹底的な

delinquency -(032 Please take a look at this chart. It indicates that juvenile delinquency is on the increase at an alarming rate.)	非行

density -(034 The population density in the metropolis is gradually decreasing.)	密度

in all likelihood -(035 In all likelihood, the birthrate will continue to decline steadily for years to come.)	(副)ほぼ間違いなく

expose A to B -(038 In fact, the inhabitants have been exposed to radiation.)	AをBにさらす

cannnot do too much -(039 One cannot emphasize too much the potential danger of nuclear energy.)	いくらdoしてもし過ぎることはない

prominent -(043 Why don't you consult Starr in person? He's by far the most prominent attorney around here.)	傑出した、著名な

compensate (A) for B -(046 They are entitled to be compensated for their injuries.)	(Aが被った)B(損害)を補償する

strain ... -(050 My grandma strained her back when she bent down to hug my son.)	...を痛める

remedy -(051 If you have a stiff neck, try an herbal remedy.)	治療

let alone ... -(053 We can't apply cloning techniques to cattle, let alone human beings. It's forbidden.)	...はなおさら(~でない)

boast about[of] ... -(056 The biologist is proud of his historic discovery and doesn't mind boasting about it.)	...を自慢げに話す

be opposed to ... -(057 On ethical grounds, they are opposed to so-called gene therapy.)	...に反対である

ethical -(057 On ethical grounds, they are opposed to so-called gene therapy.)	倫理上の、倫理的な

genuine -(062 "This is fake, isn't it?" "Hey, it's a genuine antique." "No way!")	本物の

hang out -(069 While I was hanging out at the mall, I ran into Ken.)	なんとなく時間を過ごす、ぶらぶらする

split the check -(068 "It's on me." "No. You treat me every time we eat out." "Well, okay. Let's split the check then.")	割り勘にする

as the proverb goes[says] -(074 As the proverb goes, "The end justifies the means.")	(副)諺にある通り

wind (...) up -(076 The chairman cut me off, saying, "Time to wind things up. Let's take a vote.")	(...を)終わりにする

have[be] yet to do -(077 We exchanged frank opinions in the meeting, but consensus is yet to be reached regarding this matter.)	まだdoしていない

regarding ... -(077 We exchanged frank opinions in the meeting, but consensus is yet to be reached regarding this matter.)	(前)...に関して

put ... into practice -(084 He came up with an ingenious, sensible solution and immediately put it into practice.)	...を実行に移す

ingenious -(084 He came up with an ingenious, sensible solution and immediately put it into practice.)	独創的な

defeat ... -(087 We expected him to defeat his opponent, but he failed to live up to our expectations.)	...に勝つ、...を負かす

live up to one's expectations -(087 We expected him to defeat his opponent, but he failed to live up to our expectations.)	one'sの期待に応える

fall through -(091 Without your solid support, the deal would have fallen through. I'm grateful to you.)	(動)うまくいかない

on account of ... -(093 Our flight to Vienna was delayed on account of a minor accident.)	...(好ましくないこと)が理由で

defect -(100 The vehicles are inspected for defects every three months.)	(名)欠陥

substitute ... (for A) -(105 You can substitute some transparent glue for a needle and thread.)	...を(Aの)代わりに使う

fragment -(116 After he bumped into the shelf, the priceless china fell and shattered into fragments.)	破片

keep an eye on ... -(117 Can you keep an eye on my kids for a while? I need to pick up Ken. No problem.")	...から目を離さない、...を気を付けて見る

pastime -(122 My favorite pastime is strolling along the shore. It's pleasant.)	余暇の楽しみ

stroll -(122 My favorite pastime is strolling along the shore. It's pleasant.)	ぶらぶらと歩く、散歩する

faint -(125 He fainted with hunger and fatigue, but came to after a while.)	気を失う

resent ... -(130 Lucy resented the aggressive salesman trying to make her sign the contract.)	...に腹を立てる

discourage A from doing -(131 There are a number of factors discouraging us from investing in stocks.)	A(人)にdoingする気をなくさせる

unprecedented -(134 The world is faced with an unprecedented crisis.)	(形)いまだかつてない

competitiveness -(136 In order to keep up its competitiveness in the world, Japan must undertake sweeping deregulation in earnest.)	競争力

deregulation -(136 In order to keep up its competitiveness in the world, Japan must undertake sweeping deregulation in earnest.)	規制緩和[撤廃]

in earnest -(136 In order to keep up its competitiveness in the world, Japan must undertake sweeping deregulation in earnest.)	(副,形)真剣に[な]

sweeping ... -(136 In order to keep up its competitiveness in the world, Japan must undertake sweeping deregulation in earnest.)	大幅な...

undertake ... -(136 In order to keep up its competitiveness in the world, Japan must undertake sweeping deregulation in earnest.)	...に着手する

desperate -(137 We cannot turn our backs on desperate people who are at risk.)	(形)わらにもすがる思いの

monarchy -(139 Some say the British monarchy should be abolished. What do you think?)	君主国、君主政治

disarmament -(141 There's little prospect that the two countries will make significant progress in disarmament.)	軍備縮小

prospect -(141 There's little prospect that the two countries will make significant progress in disarmament.)	可能性、見込み

abuse ... -(144 The aristocrats abused their privileges to their heart's content.)	...を乱用[悪用]する

aristocrat -(144 The aristocrats abused their privileges to their heart's content.)	貴族

in itself -(145 The revolution in itself, bore no fruit, after all.)	(副)それ自体は[が]

suspend ... -(149 When Nick and I cheated on an exam, I was suspended from school. As for Nick, he got away with it.)	...を停職[停学]にする

get away with ... -(149 When Nick and I cheated on an exam, I was suspended from school. As for Nick, he got away with it.)	...の罰をまんまと逃れる

be jealous of ... -(150 They are hostile to Richard because they are jealous of his wealth and status.)	...を妬んでいる

hostile (to/toward ...) -(150 They are hostile to Richard because they are jealous of his wealth and status.)	(形)(...に対して)敵対的な

compliment -(152 In spite of our compliments, he frowned and turned away. He was so rude!)	ほめ言葉

frown -(152 In spite of our compliments, he frowned and turned away. He was so rude!)	(動)顔をしかめる

at one's disposal -(153 He claimed that the enormous property was at his disposal.)	(形)one'sの自由にできる

beat around the bush -(155 "Don't beat around the bush! What am I supposed to do?" "Just wait and see. Time will tell.")	話をじらす

be supposed to do -(155 "Don't beat around the bush! What am I supposed to do?" "Just wait and see. Time will tell.")	doするものだと思われている

flunk (...) -(157 Joe is anything but diligent. That's why he flunked math again.)	(...(科目)を)落とす

thesis -(158 His thesis doesn't make sense. To begin with, its theme is obscure.)	論文

concise -(159 His essay was concise and to the point.)	簡潔な

I bet (that)~ -(162 "What if I don't meet the deadline?" "I bet he'll get mad at you!")	(動)きっと~だ

turn ... in -(161 "Nick, I want you to look this over before I turn it in." "Sorry, but I have my hands full right now.")	...を提出する

premise -(164 You ought to think over whether the premise is valid or not.)	(名)前提

precise -(165 Above all, scientific terms call for precise definitions.)	厳密な

concept -(169 This chapter will focus on the concepts of geometry.)	概念、考え

barely ... -(173 The minute particles are barely visible to the naked eye.)	(副)何とか...(する)、かろうじて...

minute -(173 The minute particles are barely visible to the naked eye.)	極めて小さい[細かい]

particle -(173 The minute particles are barely visible to the naked eye.)	粒子

tissue -(174 Muscle tissue consists of a vast number of cells.)	(細胞)組織

substance -(175 This substance is mostly composed of hydrogen and oxygen.)	物質

be composed of ... -(175 This substance is mostly composed of hydrogen and oxygen.)	...から構成されている

turn ... down -(178 I fell in love with Naomi at first sight. Three months later, I took a chance and proposed to her, but she turned me down.)	...のお願いごとを断る

considerate -(180 His nephew was brought up to be modest and considerate.)	思いやりのある

take to ... -(181 I introduced Bob to my folks, and they took to him at once.)	...が好きになる

count -(183 "It's not your title that counts. That's for sure!" exclaimed Bob.)	(動)重要である

exclaim (...) -(183 "It's not your title that counts. That's for sure!" exclaimed Bob.)	(...と)語気を強めて言う

as ... put it -(184 As a self-made man put it, "A man of vision will make good in the end.")	...が言うように

on earth -(186 I can't figure out why on earth everybody feels so much contempt for Bob!)	(疑問文中で)いったい

contempt (for ...) -(186 I can't figure out why on earth everybody feels so much contempt for Bob!)	(名)(...に対する)軽蔑

learn one's lesson -(187 I can't help laughing at him because he keeps on making stupid mistakes. He'd be the last person to learn his lesson.)	教訓を得る、懲りる

stumble -(190 Dave is fat and clumsy. When he leaped over the shallow stream, he stumbled and twisted his ankle.)	(動)つまずく

twist (...) -(190 Dave is fat and clumsy. When he leaped over the shallow stream, he stumbled and twisted his ankle.)	...を捻挫する

passive -(192 The passive man seldom, if ever, expresses himself in public.)	消極的な

injection -(194 I tremble with fear at the thought of an injection.)	注射

irrational -(193 Nick convinced me that all superstitions are irrational.)	(形)根拠のない

be absorbed in ... -(196 While Bob was at work, Jennifer was at home absorbed in silly soap opera.)	...に夢中になっている

think '程度' of A -(197 Bob likes cartoons, but I don't think much of them. As a matter of fact, they're boring)	Aを'程度'だと思う[評価する]

as a matter of fact -(197 Bob likes cartoons, but I don't think much of them. As a matter of fact, they're boring)	実際には


2 Section 18-23 se
hold ... back -(198 It occurred to me that he was holding something back, because he wouldn't look me in the eye.)	...(真実・感情など)を隠す

swear at ... -(199 When her patience gave out, she grabbed his collar and swore at him.)	...を罵る

drop in -(203 I can't put you up. For one thing, my dad drop in on me from time to time.)	ふらっと立ち寄る

sidewalk -(204 While Jennifer was standing still, Bob was pacing back and forth along the sidewalk.)	歩道

make up (with ...) -(205 "Let's make up, Lisa." "Stop taking me for granted! We're through for good this time.I mean it!")	(...と)仲直りする

take A for granted -(205 "Let's make up, Lisa." "Stop taking me for granted! We're through for good this time.I mean it!")	Aを当然のことと思う

be through -(205 "Let's make up, Lisa." "Stop taking me for granted! We're through for good this time.I mean it!")	終わる

for good -(205 "Let's make up, Lisa." "Stop taking me for granted! We're through for good this time.I mean it!")	永遠[永久]に

mean to do -(206 Come on! Don't get so emotional, Lisa. I didn't mean to hurt you. Let's talk it over.)	doするつもりである

get even (with ...) -(207 "You betrayed me!" "Please forgive me. How can I make it up to you?" "I'll get even!")	(...に)仕返しする

conceal ... -(208 You should confess your sins rather than conceal them.)	...を隠す

confess -(208 You should confess your sins rather than conceal them.)	(牧師に)告白する

sin -(208 You should confess your sins rather than conceal them.)	罪、過ち

lose face -(209 Keep your word; otherwise you'll end up losing face.)	評判を落とす

stick to ... -(210 Bob sticks to his moral principles and believes that honesty pays off in the long run.)	...を(あくまでも)守る

in the long run -(210 Bob sticks to his moral principles and believes that honesty pays off in the long run.)	最後には

pay off -(210 Bob sticks to his moral principles and believes that honesty pays off in the long run.)	報われる

dwell on ... -(211 "Cheer up! You couldn't help it." "I did my best." "I know. Don't dwell on the past. You can start over!")	...をくよくよ考える[話す]

be tied up -(212 "Jane, please do me a favor and give me a ride to Times Square." "I wish I could, but I'm tied up right now.")	(動)とても忙しい

Interstate -(214 The other day I ran out of gas in the middle of a busy Interstate.)	幹線道路

skid -(215 A truck driving ahead of me skidded, turned over, and scattered its load all over the road.)	スリップする

collision -(216 He recalled that a collision had been avoided by sheer luck.)	衝突

get in touch with... -(217 In case of an emergency, get in touch with my agent right away.)	...と連絡を取る

sheer ... -(216 He recalled that a collision had been avoided by sheer luck.)	(形)全くの...

intersection -(219 My rusty Ford broke down, obstructing the intersection.)	交差点

rusty -(219 My rusty Ford broke down, obstructing the intersection.)	さびた

obstruct ... -(219 My rusty Ford broke down, obstructing the intersection.)	...の進路を妨げる

dent -(220 There are so many fine scratches and dents on its surface, it's no use polishing it.)	へこみ

fine -(220 There are so many fine scratches and dents on its surface, it's no use polishing it.)	(形)細かい

it's no use[good] doing -(220 There are so many fine scratches and dents on its surface, it's no use polishing it.)	(定)doingしても無駄だ

get[be] stuck -(221 "Hey, we're stuck in a traffic jam!" "Chill out, Joe. Let's take a shortcut! We'll get there in time.")	動かなくなる、はまる

come close to ... -(223 The ambulance went out of control and came close to running over a pedestrian.)	危うく...しそうになる

pedestrian -(223 The ambulance went out of control and came close to running over a pedestrian.)	歩行者

contend that ~ -(224 He contends that primitive life once existed on Mars.)	~だと力説する

astronomer -(227 Many astronomers assume that the universe will expand infinitely.)	天文学者

applause -(228 The astronauts were greeted with spontaneous applause.)	拍手、賞賛

spontaneous -(228 The astronauts were greeted with spontaneous applause.)	(形)自然に生じる

endangered -(229 A fund was set up with a view to preserving our endangered planet.)	絶滅の危機に瀕した

with a view to doing -(229 A fund was set up with a view to preserving our endangered planet.)	doingするつもりで

massive -(230 The massive flood paralyzed the local transportation network.)	極めて大きい

paralyze... -(230 The massive flood paralyzed the local transportation network.)	...を麻痺させる

transportation -(230 The massive flood paralyzed the local transportation network.)	交通[輸送]機関

equator -(231 The equator divides the globe into two hemispheres.)	赤道

hemisphere -(231 The equator divides the globe into two hemispheres.)	半球

cruel -(232 I think it's cruel to trap animals for fur coats.)	残酷な

conservation -(233 The organization plays a principal role in wildlife conservation.)	保存、保護

be on the verge of ... -(234 Many fragile species are on the verge of extinction.)	...の寸前である

extinction -(234 Many fragile species are on the verge of extinction.)	絶滅

drought -(235 The prolonged drought did severe damage to the crops.)	(名)干ばつ

prolonged -(235 The prolonged drought did severe damage to the crops.)	(形)長引く

emission -(237 It is said that global warming is directly related to carbon dioxide emissions.)	(名)排出

call on A to do -(239 The committee called on all nations to work side by side to curb air pollution.)	Aにdoするように求める

curb ... -(239 The committee called on all nations to work side by side to curb air pollution.)	...を抑制する

side by side -(239 The committee called on all nations to work side by side to curb air pollution.)	協力し合って

glacier -(240 A satellite was launched into orbit to monitor melting glaciers.)	氷河

orbit -(240 A satellite was launched into orbit to monitor melting glaciers.)	軌道

blessing -(241 The ecologist has warned us time and again that petroleum is not only a blessing but also a curse.)	天の恵み

curse -(241 The ecologist has warned us time and again that petroleum is not only a blessing but also a curse.)	(名)災いのもと

petroleum -(241 The ecologist has warned us time and again that petroleum is not only a blessing but also a curse.)	石油

be abundant in ... -(242 The continent is abundant in fossil fuels.)	...が豊富である

region -(243 The region is relatively rich in mineral resources.)	(名)地方、地域

relatively -(243 The region is relatively rich in mineral resources.)	(副)比較的

account for ... -(244 Wheat accounts for approximately two-thirds of agricultural production in the area.)	...を占める

approximately -(244 Wheat accounts for approximately two-thirds of agricultural production in the area.)	(副)ほぼ、およそ

be indispensable for[to] ... -(245 Fertile soil is indispensable for a good harvest.)	...に不可欠である

fertile -(245 Fertile soil is indispensable for a good harvest.)	肥沃な

soil -(245 Fertile soil is indispensable for a good harvest.)	土、土壌

be characteristic of ... -(246 A humid climate is characteristic of the peninsula.)	...の特徴である

erupt -(247 The active volcano erupts at regular intervals.)	噴火する

Atlantic -(248 The Panama Canal connects the Atlantic with the Pacific.)	大西洋

Pacific -(248 The Panama Canal connects the Atlantic with the Pacific.)	太平洋

be accompanied by ... -(250 More often than not, famine is accompanied by plague.)	...が付随して起こる

famine -(250 More often than not, famine is accompanied by plague.)	飢饉

more often than not -(250 More often than not, famine is accompanied by plague.)	たいてい

plague -(250 More often than not, famine is accompanied by plague.)	疫病

devastating -(251 A devastating earthquake hit the state capital, leaving tens of thousands of residents homeless.)	壊滅的な

give way -(252 Watch out! The ceiling is giving way!)	崩れ落ちる

be likely to do -(253 The weather forecast says the typhoon is likely to accelerate and approach the coast.)	doしそうだ

it's up in the air -(254 "It's still up in the air whether the game will be called off or not." "So what? It makes no difference to me.")	(どうなるかが)決まっていない

make no difference (to ...) -(254 "It's still up in the air whether the game will be called off or not." "So what? It makes no difference to me.")	(...にとっては)どちらでも同じ

identify A with B -(256 For the most part, modernization is identified with westernization.)	AをBと同じものだと考える

modernization -(256 For the most part, modernization is identified with westernization.)	近代化

westernization -(256 For the most part, modernization is identified with westernization.)	西欧化

appear (to be) ... -(257 Urban culture appears to be attractive to many people, in particular, to younger people.)	...のように見える

A stands for ... -(258 AI stands for "artificial intelligence.")	Aは...の略[頭文字]である

make the best of... -(260 My income is not adequate to provide for my family of four, but we have to make the best of it.)	...(よくない状況)の中で何とかやっていく

rush (...) -(264 More and more people are rushing to make use of the interactive nature of the medium.)	焦る、焦ってする

have (程度) to do with ... -(265 Innovation has something to do with the ability to notice unusual phenomena.)	...と(程度の)関係がある

transform ... (into A) -(267 The once desolate valley was transformed into a thriving hub of hi-tech business.)	...を(Aへと)一変させる

invention -(268 Although there's still plenty of room for improvement, his invention is superior to conventional equipment in every respect.)	発明品

attribute A to B -(269 The strength of the firm is attributed to its unique and future-oriented strategies.)	Aの起因をBだと考える

integrate ... (into A) -(270 SONY has integrated a wide range of functions into this cool gadget. It's catching on from coast to coast.)	...を(Aに)統合させる

close at hand -(271 This tool comes in handy, so I always keep it close at hand.)	(副,形)すぐ近くに[の]

the other way around -(272 "In general, consumers prefer quantity to quality." "It's the other way around today.")	(副,形)正反対に[な]

under construction -(274 The factory now under construction will assemble 1,000 VCR units per day.)	(形)建設中の

commerce -(276 In those days, the gigantic corporation had a virtual monopoly over internal commerce.)	商取引、商業

internal -(276 In those days, the gigantic corporation had a virtual monopoly over internal commerce.)	国内の

virtual -(276 In those days, the gigantic corporation had a virtual monopoly over internal commerce.)	事実上の

come into being -(277 With restrictions removed, thousands of new enterprises have come into being.)	誕生する

restriction -(277 With restrictions removed, thousands of new enterprises have come into being.)	制限

be in danger (of ...) -(278 As a result of his ridiculous venture, he is in danger of going bankrupt.)	(...という)危険な状態にある

ridiculous -(278 As a result of his ridiculous venture, he is in danger of going bankrupt.)	(形)ばかげた

drop ... a line -(280 "I'm going to be transferred to an overseas branch." "Oh, I'll miss you. Please drop me a line.")	...に手紙を書く

transfer ... (from A) to B -(280 "I'm going to be transferred to an overseas branch." "Oh, I'll miss you. Please drop me a line.")	...を(Aから)Bに転任させる


3 Section 24-29 se
apparently ~ -(282 Apparently, Nick wasn't willing to take on the task because it would just add to his burdens.)	どうやら~のようだ

burden -(282 Apparently, Nick wasn't willing to take on the task because it would just add to his burdens.)	負担

count on ... -(285 "Nick, I'm counting on you." "OK, I'll see to it." "Thanks, I appreciate it." "Don't mention it.")	...に頼る

see to ... -(285 "Nick, I'm counting on you." "OK, I'll see to it." "Thanks, I appreciate it." "Don't mention it.")	必ず...する

be around -(286 He pretends to be enthusiastic when his boss is around.)	(自分の)近くにいる

at the expense of ...-(287 He got promoted at the expense of his colleagues. He should be ashamed of himself.)	...を犠牲にして

be ashamed of ... -(287 He got promoted at the expense of his colleagues. He should be ashamed of himself.)	...を恥ずかしく思う

colleague -(287 He got promoted at the expense of his colleagues. He should be ashamed of himself.)	同僚

lay ... off -(288 As the recession set in, temporary employees were laid off one after another.)	...を解雇する

recession -(288 As the recession set in, temporary employees were laid off one after another.)	景気後退

set in -(288 As the recession set in, temporary employees were laid off one after another.)	(好ましくないことが)始まる

be out of work -(289 Nowadays, many people are out of work against their will. Who is responsible for that?)	失業中である

pessimistic -(290 I've gotten pessimistic, and I'm worried about something I would never have been concerned about before.)	悲観的な

be confronted with ... -(291 Today, even white-collar workers are confronted with great hardships.)	...に直面する

currency -(292 The authorities are striving in vain to stabilize the currency.)	(名)通貨

stabilize ... -(292 The authorities are striving in vain to stabilize the currency.)	...を安定させる

strive -(292 The authorities are striving in vain to stabilize the currency.)	懸命に努力する

deficit -(293 We've come to the conclusion that nothing is more urgent than reducing Japan's huge deficit)	(名)赤字

distribute ... -(294 The questionnaires were distributed at random.)	...を配る

questionnaire -(294 The questionnaires were distributed at random.)	アンケート用紙

blank -(295 All you have to do is fill in the blanks below. (Please print in black or blue ink.))	(名)余白、空欄

excursion -(296 In addition to a 10% discount, you can pick out an optional excursion for free.)	日帰りツアー

prior to ... -(299 Be sure to check in at least 45 minutes prior to departure time.)	...より前に

be free of[from] ... -(302 This plastic garbage bag is free of hazardous chemicals.)	...とは無縁である

hazardous -(302 This plastic garbage bag is free of hazardous chemicals.)	有害な

be subject to ... -(307 Littering in this facility is subject to a maximum fine of $500.)	...を受ける場合がある

fine -(307 Littering in this facility is subject to a maximum fine of $500.)	罰金

litter (...) -(307 Littering in this facility is subject to a maximum fine of $500.)	(...に)ゴミを投げ捨てる

be packed -(308 That restaurant is always packed. We'd better make a reservation beforehand.)	混んでいる

beforehand -(308 That restaurant is always packed. We'd better make a reservation beforehand.)	(副)事前に

get back to ... -(309 "Sorry to interrupt your meal but I'd like a word with you in private." "Can I get back to you later?")	...に連絡しなおす[会いに行く]

in private -(309 "Sorry to interrupt your meal but I'd like a word with you in private." "Can I get back to you later?")	内密に

be astonished at[by] ... -(310 The cook was astonished at his incredible appetite.)	...にたいへん驚く

incredible -(310 The cook was astonished at his incredible appetite.)	信じられない

curious -(311 "What's going on down there? I'm curious." "I have no idea.")	好奇心旺盛な、知りたがっている

catch[get/have] a glimpse of ... -(312 Excited fans were hanging around the rear exit hoping to catch a glimpse of Michael.)	...を一瞬目にする

hang around -(312 Excited fans were hanging around the rear exit hoping to catch a glimpse of Michael.)	群がる、たむろする

rear -(312 Excited fans were hanging around the rear exit hoping to catch a glimpse of Michael.)	(形)後方の

autograph -(313 On encountering the celebrity, they asked for his autograph.)	サイン

celebrity -(313 On encountering the celebrity, they asked for his autograph.)	有名人

on doing -(313 On encountering the celebrity, they asked for his autograph.)	doingするとすぐに

diarrhea -(314 Whenever I go abroad, I suffer from jet lag and diarrhea.)	下痢

dizzy -(315 "I feel sort of dizzy and I feel like throwing up." "You look pale!")	(形)目まいがする

throw up -(315 "I feel sort of dizzy and I feel like throwing up." "You look pale!")	吐く

come down with ... -(317 "I'm afraid I'm coming down with something." "You should take a day off.")	...で体調を崩す

beverage -(318 Some of the ingredients in this beverage are harmful, especially if you are pregnant.)	(水以外の)飲み物

harmful (to...) -(318 Some of the ingredients in this beverage are harmful, especially if you are pregnant.)	(...に対して)有害な

ingredient -(318 Some of the ingredients in this beverage are harmful, especially if you are pregnant.)	成分、原料

infant -(319 Good nutrition is vital for an infant's growth.)	乳児、幼児

vital -(319 Good nutrition is vital for an infant's growth.)	極めて重要な

circulation -(320 Moderate exercise stimulates the circulation of the blood.)	循環

moderate -(320 Moderate exercise stimulates the circulation of the blood.)	適度な

stimulate ... -(320 Moderate exercise stimulates the circulation of the blood.)	(動)...を刺激する

for the time being -(321 My physician advised me to refrain from alcohol for the time being.)	当分の間は

physician -(321 My physician advised me to refrain from alcohol for the time being.)	医師

get into shape -(322 I do want to get into shape and lose some weight, so I go swimming every morning.)	体調を良くする

nasty -(323 He caught a nasty cold because he stayed up late last night.)	(形)ひどい

surgeon -(324 The surgeon persuaded him to undergo an organ transplant.)	外科医

transplant -(324 The surgeon persuaded him to undergo an organ transplant.)	移植

bedridden -(325 Since our father is bedridden, we take turns looking after him.)	(形)寝たきりの

take turns (doing) -(325 Since our father is bedridden, we take turns looking after him.)	(doingを)交代でする

excessive -(326 Our hypothesis is that eating excessive amounts of junk food contributes to early mortality.)	過度の

hypothesis -(326 Our hypothesis is that eating excessive amounts of junk food contributes to early mortality.)	仮説

mortality -(326 Our hypothesis is that eating excessive amounts of junk food contributes to early mortality.)	(名)死ぬべき運命

infection -(327 The government did not take appropriate measures to prevent the infection from spreading.)	伝染、感染

be obliged to do -(328 The minister was obliged to resign from the Cabinet.)	doせざるを得ない

minister -(328 The minister was obliged to resign from the Cabinet.)	大臣

compulsory -(329 Many people regard the current compulsory education system as being obsolete.)	強制的な、義務の

encourage A to do -(330 Many people encouraged me to fulfill my ambitions.)	Aにdoするように励ます

take (...) over -(335 As soon as he graduated from Keio University, he took over his family's business.)	(...を)引き継ぐ

cut out for ... -(336 You aren't cut out for the military because of its rigid discipline.)	...(職種)に向いている

discipline -(336 You aren't cut out for the military because of its rigid discipline.)	規律

rigid -(336 You aren't cut out for the military because of its rigid discipline.)	(規則などが)厳格な

at all costs -(337 I am determined to make a living as a playwright at all costs.)	どんな犠牲を払っても

perspective -(338 As he grew up, he learned to put things in perspective.)	(名)バランスの取れた見方

conformity -(339 Conformity is an essential element of our homogeneous community.)	(名)体制・社会通念などに従うこと

homogeneous -(339 Conformity is an essential element of our homogeneous community.)	均質な

mold -(340 I'd rather go my own way than toil away for a company. Trying to fit into a mold gets me nowhere!)	(名)型

toil away -(340 I'd rather go my own way than toil away for a company. Trying to fit into a mold gets me nowhere!)	ひたすら[あくせく]働く

give in (to ...) -(341 Tom takes after his uncle in personality. I mean, he is obstinate by nature. He never gives in.)	(...に)降参する

obstinate -(341 Tom takes after his uncle in personality. I mean, he is obstinate by nature. He never gives in.)	頑固な

take after ... -(341 Tom takes after his uncle in personality. I mean, he is obstinate by nature. He never gives in.)	...に似ている

threat -(343 I'll stand up for what I believe in and won't yield to any threats.)	脅威、脅迫

yield (to ...) -(343 I'll stand up for what I believe in and won't yield to any threats.)	(...に)屈する

conquer ... -(344 "If only I could conquer my weaknesses!" "It's up to you.")	...を克服する

if only ~ -(344 "If only I could conquer my weaknesses!" "It's up to you.")	~でありさえすればいいのになあ

make the most of ... -(345 You should make the most of this rare opportunity to demonstrate your talent.)	...(有利な状況)を最大限利用する

have faith in ... -(346 You won't let me down. I have great faith in you. You can make it!)	...を信頼している

prestigious -(348 In 1995, Ando received architecture's most prestigious award.)	権威のある

extraordinary -(349 In the face of adversity, Mike accomplished an extraordinary feat. He deserves praise.)	並外れた

in the face of ... -(349 In the face of adversity, Mike accomplished an extraordinary feat. He deserves praise.)	...をものともせず

eloquent -(350 The audience was impressed by his eloquent lecture.)	(形)説得力のある

humble -(351 From a humble background, John achieved worldwide fame.)	庶民の

accumulate ... -(352 He accumulated a tremendous fortune during the postwar era.)	...をためる

era -(352 He accumulated a tremendous fortune during the postwar era.)	時代

postwar -(352 He accumulated a tremendous fortune during the postwar era.)	戦後の

tremendous -(352 He accumulated a tremendous fortune during the postwar era.)	大きな、莫大な

generous -(353 He used to be well off and generous, but now he lives from hand to mouth.)	(形)気前のよい

live from hand to mouth -(353 He used to be well off and generous, but now he lives from hand to mouth.)	その日暮らしをする

well off -(353 He used to be well off and generous, but now he lives from hand to mouth.)	(形)裕福な


4 Section 30-33 se
by no means ... -(354 Nick is by no means satisfied with the reward. He is selfish and greedy.)	決して...しない

greedy -(354 Nick is by no means satisfied with the reward. He is selfish and greedy.)	欲の深い

reward -(354 Nick is by no means satisfied with the reward. He is selfish and greedy.)	(名)見返り、報酬

There you go again! -(355 "You owe me $200 altogether, Bob. When are you going to pay me back?" "I'm sorry. I'm hard up." "There you go again!")	またそれだ、また始まったよ！

be hard up -(355 "You owe me $200 altogether, Bob. When are you going to pay me back?" "I'm sorry. I'm hard up." "There you go again!")	お金に困っている

amount to ... -(356 To Brian's surprise, his debt amounted to a considerable sum.)	(動)...に達する

cling to ... -(357 Stop clinging to your glory days, or you'll be left behind.)	...にしがみつく

glory -(357 Stop clinging to your glory days, or you'll be left behind.)	栄光、名誉

leave ... behind -(357 Stop clinging to your glory days, or you'll be left behind.)	...を置き去りにする

adapt to ... -(358 You cannot escape from today's harsh realities, so you must adapt to them.)	...に順応する

harsh -(358 You cannot escape from today's harsh realities, so you must adapt to them.)	厳しい

one of these days -(359 Prosperity does not last forever. In other words, it will come to an end one of these days.)	いつかは、近いうちに

prosperity -(359 Prosperity does not last forever. In other words, it will come to an end one of these days.)	繁栄

qualification -(360 Proper qualifications are required for the position; computer literacy is a must.)	資格、能力

enclose ... -(361 Enclose your resume in this envelope and submit it to the personnel department.)	...を同封する

envelope -(361 Enclose your resume in this envelope and submit it to the personnel department.)	封筒

personnel -(361 Enclose your resume in this envelope and submit it to the personnel department.)	社員、職員

at best -(362 It's optimistic of you to believe that things will work out. At best there's a fifty-fifty chance.)	よくても、せいぜい

optimistic -(362 It's optimistic of you to believe that things will work out. At best there's a fifty-fifty chance.)	(形)楽観的な

work out -(362 It's optimistic of you to believe that things will work out. At best there's a fifty-fifty chance.)	うまくいく

registration -(363 Registration forms can be obtained free of charge.)	登録

inquiry -(365 For further inquiries, please feel free to contact us toll-free at 1-800-555-1212.)	問合せ、質問

cannnot make heads or tails of ... -(367 He gave instructions to the trainees, but they couldn't make heads or tails of them.)	...がさっぱりわからない

at one time -(368 You can't do two things at one time! It's out of the question. Do them one by one.)	同時に、一度に

mind your own business -(369 "Bob, don't disturb her. Mind your own business," he whispered.)	おせっかいはやめろ

lose one's temper -(370 If you persist in bothering her like that, she'll lose her temper.)	かっとなる

persist in ... -(370 If you persist in bothering her like that, she'll lose her temper.)	しつこく...する

resist (...) -(371 He was so childish that he couldn't resist temptation.)	(...を)我慢する

temptation -(371 He was so childish that he couldn't resist temptation.)	誘惑

talk back (to ...) -(373 There's no point in talking back to Nick. He is a "dictator," so to speak.)	(...に)口答えをする

there's no point in doing -(373 There's no point in talking back to Nick. He is a "dictator," so to speak.)	(定)doingするのは無駄だ

look up to ... -(375 "You despise Nick, don't you?" "On the contrary! I look up to him.")	...を尊敬する

on the contrary -(375 "You despise Nick, don't you?" "On the contrary! I look up to him.")	それどころか

arouse ... -(376 His constant insults aroused her anger.)	(動)...を呼び起こす

insult -(376 His constant insults aroused her anger.)	侮辱

be fed up (with ...) -(377 I'm fed up with just shuffling papers and pouring coffee. I've made up my mind to quit!)	(...に)うんざりしている

make up one's mind (to do) -(377 I'm fed up with just shuffling papers and pouring coffee. I've made up my mind to quit!)	(doすると)決心する

get by (on...) -(378 In reality, many people have difficulty making ends meet. How can you get by on 100,000 yen a month?)	(...で)何とか生活していく

make ends meet -(378 In reality, many people have difficulty making ends meet. How can you get by on 100,000 yen a month?)	何とかやりくりする

A might[may] well do -(379 Female clerks may well complain about their routines, which are not challenging at all.)	Aがdoするのももっともだ

challenging -(379 Female clerks may well complain about their routines, which are not challenging at all.)	(形)やりがいのある

...-fold -(380 Thanks to a fundamental restructuring, our surplus has swelled threefold.)	(尾)...倍の[に]

surplus -(380 Thanks to a fundamental restructuring, our surplus has swelled threefold.)	黒字

swell (数量) -(380 Thanks to a fundamental restructuring, our surplus has swelled threefold.)	(数量が)増大する

absurd -(381 Many people today think of loyalty to a company as an absurd notion.)	(形)ばかげた

loyalty -(381 Many people today think of loyalty to a company as an absurd notion.)	忠誠

notion -(381 Many people today think of loyalty to a company as an absurd notion.)	考え

all the way from ... -(382 I have to commute all the way from a distant suburb. I'm sick of it!)	...からはるばる

commute -(382 I have to commute all the way from a distant suburb. I'm sick of it!)	通勤する

distant -(382 I have to commute all the way from a distant suburb. I'm sick of it!)	(形)遠い

suburb -(382 I have to commute all the way from a distant suburb. I'm sick of it!)	郊外

devote A to B -(384 After retirement, Teresa devoted herself to caring for orphans.)	AをBに捧げる

orphan -(384 After retirement, Teresa devoted herself to caring for orphans.)	孤児

in need -(385 For the sake of children in need, we cooperated to collect donations.)	(形)困っている

give ... away -(386 The charity is named after a man who gave away some two billion yen.)	...をただであげる、...を寄付する

autobiography -(387 His autobiography was released today and was sold out by noon.)	自叙伝

integrity -(388 Ted, who is often referred to as a man of integrity, is going to run for mayor.)	高潔さ、誠実さ

run for ... -(388 Ted, who is often referred to as a man of integrity, is going to run for mayor.)	...に立候補する

municipal -(390 The municipal council should concentrate more on specific issues.)	市[町]の

specific -(390 The municipal council should concentrate more on specific issues.)	具体的な

force A to do -(391 It is the case that those who live on a pension are forced to lead a hard life.)	Aにdoするように強いる

it is the case that ~ -(391 It is the case that those who live on a pension are forced to lead a hard life.)	~ということは事実だ

pension -(391 It is the case that those who live on a pension are forced to lead a hard life.)	年金

politician -(391 It is the case that those who live on a pension are forced to lead a hard life.)	政治家

associate A with B -(393 We tend to associate politicians with hypocrisy.)	AからBを連想する

hypocrisy -(393 We tend to associate politicians with hypocrisy.)	偽善

enhance ... -(394 They are primarily concerned with exploiting us, not with enhancing our living standards.)	...を高める

exploit ... -(394 They are primarily concerned with exploiting us, not with enhancing our living standards.)	...から搾取する

conservative -(395 The man once exerted a dominant influence on the conservative party, but now his power is diminishing.)	保守的な

diminish -(395 The man once exerted a dominant influence on the conservative party, but now his power is diminishing.)	弱まる

dominant -(395 The man once exerted a dominant influence on the conservative party, but now his power is diminishing.)	支配的な

exert ... -(395 The man once exerted a dominant influence on the conservative party, but now his power is diminishing.)	...を行使する

spokesperson -(396 The spokesperson refused to make any comment, saying, "It's under investigation.")	報道担当者

pull strings -(397 The police say there's someone pulling strings behind the scenes.)	糸を引く、操る

bureaucrat -(398 The executives entertained the bureaucrats at ryotei, or exclusive Japanese restaurants, hoping for something in return.)	官僚

exclusive -(398 The executives entertained the bureaucrats at ryotei, or exclusive Japanese restaurants, hoping for something in return.)	排他[閉鎖]的な、高級な

in return (for ...) -(398 The executives entertained the bureaucrats at ryotei, or exclusive Japanese restaurants, hoping for something in return.)	(...の)お返しとして

flatly -(399 His secretary flatly denied leaking any confidential information.)	(副)きっぱりと

leak (...) -(399 His secretary flatly denied leaking any confidential information.)	...を漏らす

dare (to) do ... -(400 No one dares to contradict his/her employer for fear of being fired.)	(否定文で)思い切ってdoする

dignity -(401 He sacrificed his promising career to retain his dignity.)	尊厳

retain ... -(401 He sacrificed his promising career to retain his dignity.)	...を維持する

sacrifice ... -(401 He sacrificed his promising career to retain his dignity.)	...を犠牲にする

fate -(402 I might as well kill myself as reconcile myself to my fate.)	(名)運命

might as well doA as doB -(402 I might as well kill myself as reconcile myself to my fate.)	doBするくらいならdoAするほうがましだ

reconcile oneself to ... -(402 I might as well kill myself as reconcile myself to my fate.)	(動)...を仕方なく受け入れる

be about to do -(403 He was about to commit suicide by swallowing poison when he thought better of it.)	doするところである

commit ... -(403 He was about to commit suicide by swallowing poison when he thought better of it.)	...(犯罪・過失)を犯す

suicide -(403 He was about to commit suicide by swallowing poison when he thought better of it.)	(名)自殺

think better of ... -(403 He was about to commit suicide by swallowing poison when he thought better of it.)	...をしないことにする


5 Section 34-36 se
linger (on) -(404 The vague rumor proved to be false. Nevertheless, some skepticism lingers on.)	(動)まだ続いている[残っている]

skepticism -(404 The vague rumor proved to be false. Nevertheless, some skepticism lingers on.)	(名)疑い

vague -(404 The vague rumor proved to be false. Nevertheless, some skepticism lingers on.)	曖昧な、漠然とした

bribe -(405 A senior official is suspected of accepting bribes from a company, but there isn't sufficient evidence to arrest him.)	賄賂

senior -(405 A senior official is suspected of accepting bribes from a company, but there isn't sufficient evidence to arrest him.)	上級の

suspect A of B -(405 A senior official is suspected of accepting bribes from a company, but there isn't sufficient evidence to arrest him.)	AにBの容疑をかける

corruption -(406 Jason, who was in charge of the project, was dismissed for corruption.)	汚職、不正、贈賄

dismiss ... -(406 Jason, who was in charge of the project, was dismissed for corruption.)	...を解雇[解任]する

be involved in ... -(407 To my knowledge, he has not been involved in the fraud scheme.)	...に巻き込まれる、...にかかわる

fraud -(407 To my knowledge, he has not been involved in the fraud scheme.)	不正、詐欺

scheme -(407 To my knowledge, he has not been involved in the fraud scheme.)	企み、陰謀

a pile of ... -(408 They found out the truth while examining a pile of relevant documents.)	(山ほど)たくさんの...

examine ... -(408 They found out the truth while examining a pile of relevant documents.)	...を調べる

relevant (to ...) -(408 They found out the truth while examining a pile of relevant documents.)	(形)(...と)関連性のある

come to light -(409 During the trial it came to light that they had been covering up illegal transactions for decades.)	明るみに出る

cover ... up -(409 During the trial it came to light that they had been covering up illegal transactions for decades.)	...を隠す[隠ぺいする]

decade -(409 During the trial it came to light that they had been covering up illegal transactions for decades.)	(名)10年(間)

transaction -(409 During the trial it came to light that they had been covering up illegal transactions for decades.)	商取引

trial -(409 During the trial it came to light that they had been covering up illegal transactions for decades.)	裁判、審判

detective -(410 The detective took down his testimony on the spot, word for word.)	探偵、刑事

on the spot -(410 The detective took down his testimony on the spot, word for word.)	その場で、直ちに

take ... down -(410 The detective took down his testimony on the spot, word for word.)	...(人の言葉)を書き取る

testimony -(410 The detective took down his testimony on the spot, word for word.)	証言

word for word -(410 The detective took down his testimony on the spot, word for word.)	一言一句違わずに

conscience -(411 For the first time in my life, I felt a pang of conscience, but there was no other way out.)	良心

pang of ... -(411 For the first time in my life, I felt a pang of conscience, but there was no other way out.)	(名)(突然襲う精神的な)...の苦しみ

way out -(411 For the first time in my life, I felt a pang of conscience, but there was no other way out.)	逃れる道[方法]

haunt ... -(412 I'm still haunted by a vivid nightmare I had last night.)	...の心[脳裏]に付きまとう

vivid -(412 I'm still haunted by a vivid nightmare I had last night.)	鮮明な

by and large -(413 By and large, reporters don't hesitate to intrude on one's privacy.)	概して

intrude (on ...) -(413 By and large, reporters don't hesitate to intrude on one's privacy.)	(...を)侵害する

manuscript -(414 The author revised his manuscript over and over again.)	原稿

over and over (again) -(414 The author revised his manuscript over and over again.)	何度も(何度も)繰り返して

be second to none -(415 He is second to none when it comes to finding fault with others.)	(動)何にも劣らない

when it comes to ... -(415 He is second to none when it comes to finding fault with others.)	...のこととなると

criticism -(416 On the whole, the elite are not sensitive to criticism.)	批判、非難

elite -(416 On the whole, the elite are not sensitive to criticism.)	エリート(たち)

on the whole -(416 On the whole, the elite are not sensitive to criticism.)	概して

addict -(417 When a tabloid revealed that he was a drug addict, his reputation was all but ruined.)	中毒者

all but -(417 When a tabloid revealed that he was a drug addict, his reputation was all but ruined.)	(副)ほとんど

ruin ... -(417 When a tabloid revealed that he was a drug addict, his reputation was all but ruined.)	...を失墜させる

tabloid -(417 When a tabloid revealed that he was a drug addict, his reputation was all but ruined.)	大衆ゴシップ紙

flaw (in ...) -(418 They considered every aspect of the defense program and pointed out numerous flaws.)	(名)(...の)欠陥、問題箇所

numerous -(418 They considered every aspect of the defense program and pointed out numerous flaws.)	多くの

engage in ... -(419 We will not tolerate anyone who engages in terrorism.)	(動)...にかかわる

tolerate ... -(419 We will not tolerate anyone who engages in terrorism.)	...に寛容な態度を取る

confine A to B -(420 The notorious rebel was ultimately captured and confined to jail.)	AをBに閉じ込める

notorious -(420 The notorious rebel was ultimately captured and confined to jail.)	悪名高い

ultimately -(420 The notorious rebel was ultimately captured and confined to jail.)	最終的には

put ... down -(421 Troops were swiftly called in to put down the riot.)	...を鎮圧する

riot -(421 Troops were swiftly called in to put down the riot.)	暴動

swiftly -(421 Troops were swiftly called in to put down the riot.)	素早く

troop -(421 Troops were swiftly called in to put down the riot.)	軍隊

appeal to ... -(422 We should appeal to reason instead of resorting to violence.)	...に訴える

resort to ... -(422 We should appeal to reason instead of resorting to violence.)	(動)...という手段を取る

adopt ... -(423 I suggest we adopt flexible tactics for the moment.)	...を採用する

for the moment -(423 I suggest we adopt flexible tactics for the moment.)	(副)今のところは

armed forces -(424 The armed forces succeeded in occupying the entire territory.)	全軍

succeed in ... -(424 The armed forces succeeded in occupying the entire territory.)	(動)...に成功する

territory -(424 The armed forces succeeded in occupying the entire territory.)	領土

hold out -(425 Under the circumstances, the enemy has no choice but to surrender. They can't hold out any longer.)	持ちこたえる

not ... any longer -(425 Under the circumstances, the enemy has no choice but to surrender. They can't hold out any longer.)	(副)これ以上...ない

surrender (to ...) -(425 Under the circumstances, the enemy has no choice but to surrender. They can't hold out any longer.)	(...に)降伏する

hostage -(426 Sooner or later, the hostages will be set free.)	人質

deprive A of B -(427 Under the reign of tyranny, innocent people were deprived of their citizenship.)	(動)AからBを剥奪する

reign -(427 Under the reign of tyranny, innocent people were deprived of their citizenship.)	支配

tyranny -(427 Under the reign of tyranny, innocent people were deprived of their citizenship.)	専制政治

be reluctant to do -(428 Some soldiers were reluctant to obey the commands.)	doすることに気が進まない

be bound to do -(429 His regime is bound to collapse.)	きっとdoする

collapse -(429 His regime is bound to collapse.)	(動)崩壊する

regime -(429 His regime is bound to collapse.)	政権

ally -(430 The allies condemned the invasion as a violation of UN resolutions.)	同盟国

condemn ... -(430 The allies condemned the invasion as a violation of UN resolutions.)	...を厳しく非難する

invasion -(430 The allies condemned the invasion as a violation of UN resolutions.)	侵略

resolution -(430 The allies condemned the invasion as a violation of UN resolutions.)	決議

violation -(430 The allies condemned the invasion as a violation of UN resolutions.)	違反

civil war -(431 We cannot rule out the possibility that civil war will break out in that country.)	内戦、内乱

rule ... out -(431 We cannot rule out the possibility that civil war will break out in that country.)	...を排除する

colony -(432 The colony declared independence and became a republic.)	植民地

declare ... -(432 The colony declared independence and became a republic.)	...を宣言する

republic -(432 The colony declared independence and became a republic.)	共和国

erect ... -(433 An immense monument was erected in honor of the noble patriot.)	...を建てる

immense -(433 An immense monument was erected in honor of the noble patriot.)	巨大な、莫大な

in honor of ... -(433 An immense monument was erected in honor of the noble patriot.)	...に敬意を表して

monument -(433 An immense monument was erected in honor of the noble patriot.)	記念碑

noble -(433 An immense monument was erected in honor of the noble patriot.)	崇高な、高潔な

patriot -(433 An immense monument was erected in honor of the noble patriot.)	愛国者

deceased -(434 He got down on his knees and prayed for the souls of the deceased.)	故人(たち)

imperial -(435 The Supreme Court is located near the Imperial Palace.)	帝国の、天皇の

palace -(435 The Supreme Court is located near the Imperial Palace.)	宮殿

abortion -(436 The pro-choice group protested against a ban on abortion.)	妊娠中絶

pro-choice -(436 The pro-choice group protested against a ban on abortion.)	(形)中絶(合法化に)賛成の

bitter -(437 Senator Ford remained neutral in the bitter controversy.)	激しい

controversy -(437 Senator Ford remained neutral in the bitter controversy.)	論争、議論

senator -(437 Senator Ford remained neutral in the bitter controversy.)	上院議員

cope (with ...) -(438 Ford has been in a difficult situation all week long. He is no longer capable of coping with it.)	(...に)うまく対処する

no longer... -(438 Ford has been in a difficult situation all week long. He is no longer capable of coping with it.)	(副)もはや...ない

broadcast (...) -(439 The summit talks are to be broadcast simultaneously throughout the world.)	(...を)放送する

simultaneously -(439 The summit talks are to be broadcast simultaneously throughout the world.)	同時に

throughout the world -(439 The summit talks are to be broadcast simultaneously throughout the world.)	(副)世界中で

dialogue -(440 Diplomatic dialogue helped put an end to the conflict.)	対話

diplomatic -(440 Diplomatic dialogue helped put an end to the conflict.)	外交(上)の...

help (to) do -(440 Diplomatic dialogue helped put an end to the conflict.)	doするのに役立つ

put an end to ... -(440 Diplomatic dialogue helped put an end to the conflict.)	(動)...に終止符を打つ

appoint ... -(441 Johnson was appointed as a goodwill ambassador to foster mutual understanding between the two nations.)	...を任命する

foster ... -(441 Johnson was appointed as a goodwill ambassador to foster mutual understanding between the two nations.)	...を育む

goodwill -(441 Johnson was appointed as a goodwill ambassador to foster mutual understanding between the two nations.)	親善、友好

mutual -(441 Johnson was appointed as a goodwill ambassador to foster mutual understanding between the two nations.)	相互の

build up -(442 The specialist predicts international tension will build up.)	高まる

tension -(442 The specialist predicts international tension will build up.)	緊張

nothing but ... -(443 In my opinion, permanent peace is nothing but an illusion.)	(定)...に過ぎない

ethnic -(444 Ethnic minorities struggle against prejudice, poverty, and oppression.)	(形)民族の

oppression -(444 Ethnic minorities struggle against prejudice, poverty, and oppression.)	抑圧

poverty -(444 Ethnic minorities struggle against prejudice, poverty, and oppression.)	貧困

struggle -(444 Ethnic minorities struggle against prejudice, poverty, and oppression.)	必死に戦う

discrimination -(445 We must make every effort to do away with all discrimination.)	差別

do away with ... -(445 We must make every effort to do away with all discrimination.)	...を捨てる

amendment -(447 The amendment was rejected because it didn't take racial diversity into account.)	改正案

racial ... -(447 The amendment was rejected because it didn't take racial diversity into account.)	人種の...

long for ... -(448 Needless to say, the refugees were longing for freedom.)	...を切望する

refugee -(448 Needless to say, the refugees were longing for freedom.)	難民


6 Section 37-40 se
be indifferent to ... -(449 According to a survey, three in five people today are indifferent to foreign affairs.)	...に無関心である

treaty -(450 What will become of Japan-U.S. relations if the security treaty expires?)	条約

What will become of ...? -(450 What will become of Japan-U.S. relations if the security treaty expires?)	(定)...はどうなってしまうのだろう?

expire -(450 What will become of Japan-U.S. relations if the security treaty expires?)	期限切れになる

eliminate ... -(451 Unless Japan eliminates its unfair tariffs, the U.S. will impose sanctions.)	...を取り除く

impose ... (on A) -(451 Unless Japan eliminates its unfair tariffs, the U.S. will impose sanctions.)	(Aに)..を課す

sanction -(451 Unless Japan eliminates its unfair tariffs, the U.S. will impose sanctions.)	制裁

tariff -(451 Unless Japan eliminates its unfair tariffs, the U.S. will impose sanctions.)	関税

trade -(452 Trade friction might arise between the two nations at any moment.)	貿易

at any moment -(452 Trade friction might arise between the two nations at any moment.)	(副)今にも

dispute -(453 Our top priority is to settle this dispute once and for all, so we are ready to meet them halfway.)	論争、紛争

meet ... halfway -(453 Our top priority is to settle this dispute once and for all, so we are ready to meet them halfway.)	...と妥協する

congress -(454 The federal budget was narrowly approved by Congress.)	議会

federal -(454 The federal budget was narrowly approved by Congress.)	連邦政府の

narrowly -(454 The federal budget was narrowly approved by Congress.)	(副)かろうじて

administration -(455 He argues that the administration must look for alternative sources of revenue.)	政府、政権

alternative... -(455 He argues that the administration must look for alternative sources of revenue.)	代わりの...

argue (that ~) -(455 He argues that the administration must look for alternative sources of revenue.)	(~だと)主張する

revenue -(455 He argues that the administration must look for alternative sources of revenue.)	歳入

be in favor of ... -(456 A poll shows that an overwhelming majority is in favor of the legislation.)	(動)...を支持する

poll -(456 A poll shows that an overwhelming majority is in favor of the legislation.)	世論調査

legislation -(456 A poll shows that an overwhelming majority is in favor of the legislation.)	法律

majority -(456 A poll shows that an overwhelming majority is in favor of the legislation.)	(名)過半数、大多数

overwhelming -(456 A poll shows that an overwhelming majority is in favor of the legislation.)	圧倒的な

brutal -(457 The cops are searching for clues to the brutal murder.)	残虐な

insane -(458 The man must be insane. He can't distinguish vice from virtue.)	狂気の、正気ではない

vice -(458 The man must be insane. He can't distinguish vice from virtue.)	悪いこと

virtue -(458 The man must be insane. He can't distinguish vice from virtue.)	正しいこと

correspond (to/with ...) -(459 The fingerprints left on the weapon correspond with the suspect's.)	(...に)一致する

accuse ... (of A) -(460 It took us all by surprise when the noted psychologist was accused of kidnapping.)	(Aの理由で)...を訴える

kidnapping -(460 It took us all by surprise when the noted psychologist was accused of kidnapping.)	誘拐

noted -(460 It took us all by surprise when the noted psychologist was accused of kidnapping.)	有名な、著名な

jury -(461 The jury's guilty verdict gave rise to widespread debate.)	陪審団

give rise to ... -(461 The jury's guilty verdict gave rise to widespread debate.)	...を引き起こす

verdict -(461 The jury's guilty verdict gave rise to widespread debate.)	評決

widespread -(461 The jury's guilty verdict gave rise to widespread debate.)	(形)広範囲にわたる

mercy -(462 The man pleaded for mercy, but he was sentenced to twenty years in prison for his crime.)	慈悲、情状酌量

plead (with ...) (for A) -(462 The man pleaded for mercy, but he was sentenced to twenty years in prison for his crime.)	(...に)(Aを)請願する

sentence ... (to A) -(462 The man pleaded for mercy, but he was sentenced to twenty years in prison for his crime.)	...に(Aという)判決を下す

come up -(463 The officer on duty perceived an elderly man coming up behind him.)	近づいてくる

elderly -(463 The officer on duty perceived an elderly man coming up behind him.)	(形)お年寄りの

perceive ... -(463 The officer on duty perceived an elderly man coming up behind him.)	(動)...に気付く

catch sight of ... -(464 He caught sight of a thief attempting to break into the house.)	...をちらっと見かける

witness ... -(465 The day before yesterday he witnessed a weird incident in the wilderness.)	...を目撃する

weird -(465 The day before yesterday he witnessed a weird incident in the wilderness.)	奇妙な

wilderness -(465 The day before yesterday he witnessed a weird incident in the wilderness.)	原野

in sight -(466 I became aware of someone staring at me from across the aisle, so I turned around. But there was no one in sight.)	(副)視界に

stare (at ...) -(466 I became aware of someone staring at me from across the aisle, so I turned around. But there was no one in sight.)	(...を)じっと見つめる

relief -(468 Informed of her safety, he breathed a sigh of relief.)	安堵

penetrate (...) -(469 The bullet penetrated his chest, leaving him in critical condition.)	(...を)突き抜ける

deliberately -(470 At present, it's still uncertain whether it was done deliberately or by accident.)	故意に

burn down -(471 A deli caught fire and burned down, leaving a heap of ashes.)	全焼する

warehouse -(472 All of a sudden the fireworks warehouse exploded, and it took two days to put out the blaze.)	倉庫、貯蔵庫

all of a sudden -(472 All of a sudden the fireworks warehouse exploded, and it took two days to put out the blaze.)	(副)突然

blaze -(472 All of a sudden the fireworks warehouse exploded, and it took two days to put out the blaze.)	激しい炎

put ... out -(472 All of a sudden the fireworks warehouse exploded, and it took two days to put out the blaze.)	...を消す

go off -(473 A bomb went off in a thirty-story building, and more than fifty people were seriously wounded.)	爆発する

wounded -(473 A bomb went off in a thirty-story building, and more than fifty people were seriously wounded.)	(形)負傷した

Mediterranean -(474 A cargo vessel, bound for Athens, sank in Mediterranean without a trace.)	地中海

cargo -(474 A cargo vessel, bound for Athens, sank in Mediterranean without a trace.)	(名)貨物

trace -(474 A cargo vessel, bound for Athens, sank in Mediterranean without a trace.)	跡、形跡

vessel -(474 A cargo vessel, bound for Athens, sank in Mediterranean without a trace.)	船舶

reckless -(475 The reckless men froze to death during their expedition to the Antarctic.)	無謀な

... to death -(475 The reckless men froze to death during their expedition to the Antarctic.)	(副)...の結果死ぬ

Antarctic -(475 The reckless men froze to death during their expedition to the Antarctic.)	南極(地方)

expedition -(475 The reckless men froze to death during their expedition to the Antarctic.)	探検旅行

so as to do -(476 The tragedy must be remembered so as not to be repeated.)	(副)doするために

tragedy -(476 The tragedy must be remembered so as not to be repeated.)	(名)悲劇的な出来事

insight (into ...) -(477 The exhibition offers profound insights into ancient civilization.)	(名)(...に対する)洞察、深い理解力

profound -(477 The exhibition offers profound insights into ancient civilization.)	(形)(意味・教養などが)深い

seed -(478 Giotto is credited with sowing the seeds of the Italian Renaissance.)	種、きっかけ

sow (...) -(478 Giotto is credited with sowing the seeds of the Italian Renaissance.)	...をまく、種をまく

credit A with[for] B -(478 Giotto is credited with sowing the seeds of the Italian Renaissance.)	BをAの実績として認める

mount ... -(479 Bob mounted the portrait in a fancy frame, but it was upside down.)	...を載せる

Middle Ages -(480 This magnificent cathedral dates back to the Middle Ages.)	中世(西洋史1100-1500年頃)

cathedral -(480 This magnificent cathedral dates back to the Middle Ages.)	大聖堂

magnificent -(480 This magnificent cathedral dates back to the Middle Ages.)	(形)荘厳な

sculpture -(481 Asian religions inspired him to create splendid sculptures.)	彫刻作品

splendid -(481 Asian religions inspired him to create splendid sculptures.)	素晴らしい

masterpiece -(483 The millionaire insisted on acquiring the masterpiece no matter how much it cost.)	傑作

be fluent in ... -(485 The linguist is fluent in several Chinese dialects.)	...を流暢に話す

linguist -(485 The linguist is fluent in several Chinese dialects.)	言語学者

tribe -(486 The tribe worships its ancestors and speaks its own language, which is not familiar to us.)	(名)部族

worship (...) -(486 The tribe worships its ancestors and speaks its own language, which is not familiar to us.)	(...を)崇拝する

anthropologist -(487 The anthropologist says old customs still prevail in the province.)	人類学者

prevail -(487 The anthropologist says old customs still prevail in the province.)	(動)広く行われている

wicked -(488 The wicked witch cast an evil spell on the man and turned him into a bug.)	意地の悪い

cast a spell (on ...) -(488 The wicked witch cast an evil spell on the man and turned him into a bug.)	(...に)呪文[魔法]をかける

steep -(489 They proceeded along the steep path, which was the sole access to the border.)	傾斜が急な

sole -(489 They proceeded along the steep path, which was the sole access to the border.)	唯一の

ape -(490 When a big ape emerged from the cave, they got frightened and ran away.)	猿、類人猿

emerge -(490 When a big ape emerged from the cave, they got frightened and ran away.)	現れる

frighten ... -(490 When a big ape emerged from the cave, they got frightened and ran away.)	...をおびえさせる

vanish -(491 "Believe it or not, I saw an alien and then it vanished!" "Give me a break!")	消える

7 Section 41-45 se
it won't be long before ~ -(493 It won't be long before everything is ready. In the meantime, help yourself to some snacks.)	~するまでもうすぐだ

outfit -(494 Dressed in a loud and peculiar outfit, she stood out in the crowd.)	服装、衣装

stand out -(494 Dressed in a loud and peculiar outfit, she stood out in the crowd.)	(動)目立つ、際立つ

touch ... -(495 All the guests were touched by her hospitality.)	...を感動させる

shabby -(496 Her shabby clothes were not suitable for the occasion.)	ぼろぼろの、みすぼらしい

acquaintance -(497 That topic is too intimate to share with casual acquaintances.)	知人

casual -(497 That topic is too intimate to share with casual acquaintances.)	偶然の

intimate -(497 That topic is too intimate to share with casual acquaintances.)	とても私的な

crude -(498 When Tom gets drunk, he gets crude and offensive. Stay away from him.)	下品な、卑猥な

keep[stay] away from ... -(498 When Tom gets drunk, he gets crude and offensive. Stay away from him.)	...に近づかない

offensive -(498 When Tom gets drunk, he gets crude and offensive. Stay away from him.)	(形)不快にさせる

comprehend ... -(499 He could hardly comprehend what she was implying.)	...を理解する

embarrassed -(500 Bob felt embarrassed when he was teased in front of some girls.)	どぎまぎした、恥ずかしい

tease (...) -(500 Bob felt embarrassed when he was teased in front of some girls.)	(...を)からかう

all the more -(501 His ambiguous reply made her all the more irritated.)	(副)なおさら、いっそう

ambiguous -(501 His ambiguous reply made her all the more irritated.)	曖昧な

irritate ... -(501 His ambiguous reply made her all the more irritated.)	...をいらいらさせる

blush -(502 Bob is very timid and blushes when chatting with girls.)	(動)赤面する

timid -(502 Bob is very timid and blushes when chatting with girls.)	臆病な

look down on ... -(503 Nick looks down on anyone who comes from a rural area.)	...を見下す

miserable -(504 "What's the matter, Bob? You look so miserable." "Leave me alone. It's none of your business.")	惨めな、とても不幸な

at a glance -(505 Although Bob was in disguise, I recognized him at a glance.)	(副)一目見て

in disguise -(505 Although Bob was in disguise, I recognized him at a glance.)	変装して

backward(s) -(506 "What are you chuckling about?" "Bob, you have your sweatshirt on backwards!" "Oops!")	後ろ前に

chuckle -(506 "What are you chuckling about?" "Bob, you have your sweatshirt on backwards!" "Oops!")	くすくす笑う

keep to ... -(507 He is not good at making friends and always keeps to himself.)	(動)...から離れない

belong -(508 Having found no place he felt he belonged, he was extremely uneasy and lonely.)	(動)受け入れられる場所にいる

adjust to ... -(509 I found it pretty hard to adjust to my new surroundings.)	...に順応する

surroundings -(509 I found it pretty hard to adjust to my new surroundings.)	環境

sophisticated -(510 I felt utterly out of place among those sophisticated people.)	洗練された

utterly -(510 I felt utterly out of place among those sophisticated people.)	(副)全く

be into ... -(511 To tell the truth, I don't like classical music. On the other hand, Molly is really into it.)	...にはまっている

derive A from B -(512 Bob derives please from observing insects.)	(動)BからAを引き出す

for a change -(513 "How about playing cards or something for a change?" "Sorry, I'm not up for it.")	(副)気分転換に

mature -(515 His niece is sociable and mature for her age. She could pass for twenty-something.)	(形)大人になった

niece -(515 His niece is sociable and mature for her age. She could pass for twenty-something.)	姪

pass for ... -(515 His niece is sociable and mature for her age. She could pass for twenty-something.)	...として通用する

pay attention to ... -(519 It may seem trivial to you but for me it's worth paying attention to.)	(動)...に注意を払う

as far as A is concerned -(520 As far as Bob is concerned, anything goes. By contrast, Jane is very cautious.)	Aに関しては

cautious -(520 As far as Bob is concerned, anything goes. By contrast, Jane is very cautious.)	用心深い、慎重な

drag ... -(521 After an awkward pause, Bill took her by the hand and dragged her upstairs.)	...を無理に引っ張って進む

comfort ... -(522 Bill just wanted to comfort Monica, but she interpreted it as romantic interest.)	(動)...を慰める

interpret A (as B) -(522 Bill just wanted to comfort Monica, but she interpreted it as romantic interest.)	Aを(Bの意味に)解釈する

creep -(523 After making sure she was sound asleep, he crept out of the room and set off.)	静かに歩く

set off -(523 After making sure she was sound asleep, he crept out of the room and set off.)	出発する

sound -(523 After making sure she was sound asleep, he crept out of the room and set off.)	(副)深く

come across ... -(524 Between you and me, Lisa, I came across Nick passionately embracing a woman.)	...を偶然見つける

embrace (...) -(524 Between you and me, Lisa, I came across Nick passionately embracing a woman.)	(...を)強く抱きしめる

passionately -(524 Between you and me, Lisa, I came across Nick passionately embracing a woman.)	情熱的に

be open to ... -(525 Such a remark is open to misunderstanding.)	(動)...を受けやすい

remark -(525 Such a remark is open to misunderstanding.)	発言

stand ... -(526 "I can't stand it anytmore!" "Calm down. I'll come over as soon as possible.")	...に我慢する

be inclined to do -(527 Don't take it literally. He is inclined to exaggerate.)	doする傾向がある

exaggerate (...) -(527 Don't take it literally. He is inclined to exaggerate.)	(動)(...を)大げさに表現する

be in a good mood -(528 "You should apologize to Lisa for making fun of her. You went too far this time." "Yeah ... I will, sometime when she's in a better mood.")	(動)機嫌がいい

divorce (...) -(529 "Lisa, are you getting along with Nick?" "Once in a while, I think of divorcing him." "You must be kidding!")	(...と)離婚する

get along (well) with ... -(529 "Lisa, are you getting along with Nick?" "Once in a while, I think of divorcing him." "You must be kidding!")	...とうまくやっていく

in tears -(530 In tears, she tore up his letter and threw it away.)	泣きながら

tear ... up -(530 In tears, she tore up his letter and threw it away.)	...を引き裂く

deceive ... -(531 "Jennifer deceived me!" "You should have known better than to trust her.")	...をだます

adolescence -(533 I cannot look back on my adolescence without feeling depressed.)	思春期

depressed -(533 I cannot look back on my adolescence without feeling depressed.)	憂鬱な

look back (on ...) -(533 I cannot look back on my adolescence without feeling depressed.)	(...を)振り返る

see ... off -(535 "No wonder she didn't show up to see him off." "How come?" "They broke up." "Oh, what a pity!")	...を見送る

sob -(536 "Living here all by myself is torture!" he sobbed.)	すすり泣く

torture -(536 "Living here all by myself is torture!" he sobbed.)	(名)拷問

ask ... out -(537 "To be honest, I'm crazy about Ken because he's brave, self-confident, and never afraid of taking risks." "If I were you, I'd ask him out!")	(動)...をデートに誘う

go with ... -(538 "I've been going with Jennifer on and off for ages." "You're as indecisive as ever. Isn't it about time you settled down?")	...と付き合う

indecisive -(538 "I've been going with Jennifer on and off for ages." "You're as indecisive as ever. Isn't it about time you settled down?")	(形)決断力のない

settle down -(538 "I've been going with Jennifer on and off for ages." "You're as indecisive as ever. Isn't it about time you settled down?")	身を固める

all along -(539 "It dawned on me that I had been taken in by Jennifer all along." "How naive! Didn't you see through her?")	最初からずっと

be taken in by ... -(539 "It dawned on me that I had been taken in by Jennifer all along." "How naive! Didn't you see through her?")	...にだまされる

it dawns on A that ~ -(539 "It dawned on me that I had been taken in by Jennifer all along." "How naive! Didn't you see through her?")	~ということにAが気付いてくる

see through ... -(539 "It dawned on me that I had been taken in by Jennifer all along." "How naive! Didn't you see through her?")	...の正体を見抜く

be seeing ... -(540 Even though she is seeing someone else, I won't give her up.)	...と付き合っている

delight -(543 "Delight" is the opposite of "sorrow.")	喜び

go so far as to do -(544 "Jennifer went so far as to call me an idiot and she wouldn't take it back." "Serves you right! You provoked her, didn't you?")	doさえもする

provoke ... -(544 "Jennifer went so far as to call me an idiot and she wouldn't take it back." "Serves you right! You provoked her, didn't you?")	...を引き起こす、...を挑発する

arrogance -(545 "Why do you put up with her arrogance? She's just taking advantage of you." "Shut up!")	傲慢さ

take advantage of ... -(545 "Why do you put up with her arrogance? She's just taking advantage of you." "Shut up!")	...を悪用する

reflect on[upon] ... -(546 Take your time. I know you need a couple of days to reflect on it.)	(動)...をよく考える

get through ... -(547 Bob has to get through this ordeal on his own.)	...を乗り切る

ordeal -(547 Bob has to get through this ordeal on his own.)	厳しい試練

interfere (with ...) -(548 Flies and mosquitoes interfered with his meditation.)	(...の)邪魔をする

ritual -(549 The sacred ritual took place after being postponed twice.)	儀式

sacred -(549 The sacred ritual took place after being postponed twice.)	神聖な

all at once -(550 All at once, the Buddhist priest burst into laughter, spoiling the solemn atmosphere.)	(副)突然

burst into ... -(550 All at once, the Buddhist priest burst into laughter, spoiling the solemn atmosphere.)	(動)突然...の状態になる

solemn -(550 All at once, the Buddhist priest burst into laughter, spoiling the solemn atmosphere.)	(形)厳粛な

sneeze -(551 Cover your mouth when you cough, sneeze, or yawn.)	くしゃみをする

yawn -(551 Cover your mouth when you cough, sneeze, or yawn.)	あくびをする

funeral -(553 Besides attending the funeral, she needs to make all the arrangements.)	葬式

make arrangements -(553 Besides attending the funeral, she needs to make all the arrangements.)	段取りをつける

grief -(554 "I feel for you, Jane. Grief doesn't fade away quickly." "I'm OK. I'll get over it.")	深い悲しみ
